11101
1PC01
10001
100E1
11111
