11111111111111
1P100000000001
101E1111110001
100C0000000001
11000011100001
10000000000001
10000000000001
10000000000001
11111111111111
