11111111111111
1P100000CCC0C1
101E111111CCC1
10000000000001
1000CC11100001
11111111111111
