111111
101101
11P001
110101
101CE1
111111
