11111111111111
1P0C0000CCC0C1
101E111111CCC1
11111111111111
